うぃざーどりぃ	Wizardry	名詞	
えるふ	エルフ	名詞	
ひゅーまん	ヒューマン	名詞	
どわーふ	ドワーフ	名詞	
のーむ	ノーム	名詞	
ぽーくる	ポークル	名詞	
そうるらんく	ソウルランク	名詞	
ふぁいたー	ファイター	名詞	
しーふ	シーフ	名詞	
ぷりーすと	プリースト	名詞	
めいじ	メイジ	名詞	
らっしゅすとらいく	ラッシュストライク	名詞	
がーどこあ	ガードコア	名詞	
とりっくすたー	トリックスター	名詞	
さいどわいんだー	サイドワインダー	名詞	
すとらてじすと	ストラテジスト	名詞	
うぃっちくらふと	ウィッチクラフト	名詞	
あぐれべいと	アグレベイト	名詞	
ばっしゅ	バッシュ	名詞	
れっぐばっしゅ	レッグバッシュ	名詞	
うぉーくらい	ウォークライ	名詞	
らうんどすいーぷ	ラウンドスイープ	名詞	
へっどばっしゅ	ヘッドバッシュ	名詞	
がーどくらっしゅ	ガードクラッシュ	名詞	
さいだいじゅうりょうじょうしょう	最大重量上昇	名詞	
ぱわーちゃーじ	パワーチャージ	名詞	
しょっくうぇーぶ	ショックウェーブ	名詞	
ぶつりこうげきりょくじょうしょう	物理攻撃力上昇	名詞	
ですぺらーど	デスペラード	名詞	
ぼるてーじ	ボルテージ	名詞	
ぴあしんぐ	ピアシング	名詞	
でぃふぇんどすたんす	ディフェンドスタンス	名詞	
せんちねるがーど	センチネルガード	名詞	
ぷろヴぉーく	プロヴォーク	名詞	
あべんじ	アベンジ	名詞	
へいとじょうしょう	ヘイト上昇	名詞	
ぶつりぼうぎょりょくじょうしょう	物理防御力上昇	名詞	
れいじ	レイジ	名詞	
ｇｐかいふくりょくじょうしょう	GP回復力上昇	名詞	
せるふひーる	セルフヒール	名詞	
おーばーゆーず	オーバーユーズ	名詞	
ぺいしぇんす	ペイシェンス	名詞	
おふぇんしぶがーど	オフェンシブガード	名詞	
ｈｐじょうげんちじょうしょう	HP上限値上昇	名詞	
あいあんしぇる	アイアンシェル	名詞	
はいどあたっく	ハイドアタック	名詞	
わーぜんぶろう	ワーゼンブロウ	名詞	
おｄかいふくりょくじょうしょう	OD回復力上昇	名詞	
さどんすとらいく	サドンストライク	名詞	
へいとちくせきりょうげんしょう	ヘイト蓄積量減少	名詞	
ばっくあたあっく	バックアタック	名詞	
たくみのわざ	匠の技	名詞	
すぴあとらっぷ	スピアトラップ	名詞	
どろっぷりつじょうしょう	ドロップ率上昇	名詞	
ききみみ	聞き耳	名詞	
ぽいんずんとらっぷ	ポイズントラップ	名詞	
とらっぷりりーす	トラップリリース	名詞	
ぴっきんぐ	ピッキング	名詞	
あしっどぱーつ	アシッドパーツ	名詞	
ゆさぶる	揺さぶる	名詞	
こうしょうじゅつ	交渉術	名詞	
かっとぱーつ	カットパーツ	名詞	
ぼむえんど	ボムエンド	名詞	
あんちれじすとぱーつ	アンチレジストパーツ	名詞	
すぱいくぱーつ	スパイクパーツ	名詞	
くらっしゅぱーつ	クラッシュパーツ	名詞	
ぶろうえんど	ブロウエンド	名詞	
たぶえんど	タブエンド	名詞	
しんちょうにさぐる	慎重に探る	名詞	
すてぃーるあたっく	スティールアタック	名詞	
でこい	デコイ	名詞	
めいくめでぃすん	メイクメディスン	名詞	
すてるす	ステルス	名詞	
じょうじあしおとていか	常時足音低下	名詞	
へいとぶれいむ	ヘイトブレイム	名詞	
めでぃすんしゃわー	メディスンシャワー	名詞	
はいめでぃすん	ハイメディスン	名詞	
さいれんとむーぶ	サイレントムーブ	名詞	
へいとれしーぶ	ヘイトレシーブ	名詞	
うぃーくねすぶれいむ	ウィークネスブレイム	名詞	
くいっくむーぶ	クイックムーブ	名詞	
うぃーくねすれしーぶ	ウィークネスレシーブ	名詞	
ひーる	ヒール	名詞	
きゅあぽいずん	キュアポイズン	名詞	
ぷろてくしょん	プロテクション	名詞	
りぺあしーるど	リペアシールド	名詞	
ひーるさーくる	ヒールサークル	名詞	
きゅあぱらりしす	キュアパラリシス	名詞	
れじすと	レジスト	名詞	
あたっくおーら	アタックオーラ	名詞	
みどるひーる	ミドルヒール	名詞	
きゅあぼでぃ	キュアボディ	名詞	
きゅあまいんど	キュアマインド	名詞	
ますぷろてくしょん	マスプロテクション	名詞	
まじっくおーら	マジックオーラ	名詞	
りばいぶ	リバイブ	名詞	
しんたいていこうりょくじょうしょう	身体抵抗力上昇	名詞	
ますれじすと	マスレジスト	名詞	
ｍｐじょうげんちじょうしょう	MP上限値上昇	名詞	
みどるひーるさーくる	ミドルヒールサークル	名詞	
こうそくえいしょう	高速詠唱	名詞	
でぃばいんひーる	ディバインヒール	名詞	
りざれくしょん	リザレクション	名詞	
らいふりりーふ	ライフリリーフ	名詞	
ほわいとばっかー	ホワイトバッカー	名詞	
でぃばいんあーまー	ディバインアーマー	名詞	
とーちらいと	トーチライト	名詞	
だめーじかばー	ダメージカバー	名詞	
すたんすまっしゅ	スタンスマッシュ	名詞	
ほーりーらいと	ホーリーライト	名詞	
まほうぼうぎょりょくじょうしょう	魔法防御力上昇	名詞	
ふぁすとぶれいく	ファストブレイク	名詞	
はーむれす	ハームレス	名詞	
せいくりっどばりあ	セイクリッドバリア	名詞	
でぃばいんとらっぷ	ディバイントラップ	名詞	
ふれいむあろー	フレイムアロー	名詞	
えあうぉーる	エアウォール	名詞	
ふぁいあぶらすと	ファイアブラスト	名詞	
あーすとれまー	アーストレマー	名詞	
あいすばーすと	アイスバースト	名詞	
まじっくみさいる	マジックミサイル	名詞	
いんべすとふれいむ	インベストフレイム	名詞	
まほうこうげきりょくじょうしょう	魔法攻撃力上昇	名詞	
らいふすてぃーる	ライフスティール	名詞	
ｍｐじょうげんちじょうしょう	MP上限値上昇	名詞	
まなすてぃーる	マナスティール	名詞	
ふぁいあぼーる	ファイアボール	名詞	
あーすくえいく	アースクエイク	名詞	
あいすぴらー	アイスピラー	名詞	
えあうぉーるず	エアウォールズ	名詞	
にゅーくりあぶらすと	ニュークリアブラスト	名詞	
ぽいずんがす	ポイズンガス	名詞	
ヴぃくてぃむりたーん	ヴィクティムリターン	名詞	
ぱらりしすうぃんど	パラリシスウィンド	名詞	
あくとばいんど	アクトバインド	名詞	
あーまーめると	アーマーメルト	名詞	
むーぶばいんど	ムーブバインド	名詞	
くいっくきゃすと	クイックキャスト	名詞	
はーどばいんど	ハードバインド	名詞	
ろいやるしょっぷ	ロイヤルショップ	名詞	
ぷちろいやるしょっぷ	プチロイヤルショップ	名詞	
どらぐーんぞく	ドラグーン族	名詞	
あざるすたいりく	アザルス大陸	名詞	
だるあこうこく	ダルア皇国	名詞	
でぃめんとおうこく	ディメント王国	名詞	
くぉぱてぃほうせいいん	クォパティ法制院	名詞	
はーさんとれんぽう	ハーサント連邦	名詞	
どらぐーん	ドラグーン	名詞	
どらぐーん	ドラグーン族	短縮よみ	
ぷちろいやる	プチロイヤルショップ	短縮よみ	
あざるす	アザルス	名詞	
あざるす	アザルス大陸	短縮よみ	
だるあ	ダルア	名詞	
だるあ	ダルア皇国	短縮よみ	
でぃめんと	ディメント	名詞	
でぃめんと	ディメント王国	短縮よみ	
くぉぱてぃ	クォパティ	名詞	
くぉぱてぃ	クォパティ法制院	短縮よみ	
ほうせいいん	法制院	名詞	
ほうせいいん	クォパティ法制院	名詞	
ふるきものども	古き者共	名詞	
はーさんと	ハーサント	名詞	
はーさんと	ハーサント連邦	短縮よみ	
たいりく	アザルス大陸	短縮よみ	
こうこく	ダルア皇国	短縮よみ	
おうこく	ディメント王国	短縮よみ	
れんぽう	ハーサント連邦	短縮よみ	
やみてんし	闇天使	名詞	
あざるすれき	アザルス歴	名詞	
かりぐらーぜ	カリグラーゼ	名詞	
かりぐらーぜ	カリグラーゼ下水道	短縮よみ	
げすいどう	カリグラーゼ下水道	短縮よみ	
げすい	カリグラーゼ下水道	短縮よみ	
かおか・ばらーじいせき	カオカ・バラージ遺跡	名詞	
かおかばらーじいせき	カオカ・バラージ遺跡	短縮よみ	
かおか	カオカ・バラージ遺跡	短縮よみ	
かおか	カオカ	名詞	
いせき	カオカ・バラージ遺跡	短縮よみ	
でるてぃすおおくらしつ	デルティス大蔵室	名詞	
でるてぃすだいぞうしつ	デルティス大蔵室	名詞	
でるてぃす	デルティス	名詞	
でるてぃす	デルティス大蔵室	短縮よみ	
おおくらしつ	大蔵室	名詞	
おおくらしつ	デルティス大蔵室	短縮よみ	
だいぞうしつ	大蔵室	名詞	
だいぞうしつ	デルティス大蔵室	短縮よみ	
こうりゅうのしんでんあと	黄龍の神殿跡	名詞	
こうりゅう	黄龍	名詞	
こうりゅう	黄龍の神殿跡	短縮よみ	
しんでんあと	神殿跡	名詞	
しんでんあと	黄龍の神殿跡	短縮よみ	
しんでん	黄龍の神殿跡	短縮よみ	
おうりゅう	黄龍	名詞	
おうりゅうのしんでんあと	黄龍の神殿跡	名詞	
きりゅう	黄龍	名詞	
おうりゅう	黄龍の神殿跡	短縮よみ	
きりゅうのしんでんあと	黄龍の神殿跡	名詞	
きりゅう	黄龍の神殿跡	短縮よみ	
ちこるじょうあと	チコル城趾	名詞	
ちこるじょうし	チコル城趾	名詞	
ちこるしろあと	チコル城趾	名詞	
ちこる	チコル	名詞	
ちこる	チコル城趾	短縮よみ	
しろあと	城趾	名詞	
しろあと	チコル城趾	短縮よみ	
じょうし	城趾	名詞	
じょうし	チコル城趾	短縮よみ	
ありあがわちょすいくつ	アリア川貯水窟	名詞	
ありあがわ	アリア川	名詞	
ありあがわ	アリア川貯水窟	短縮よみ	
ありあ	アリア	名詞	
ありあ	アリア川貯水窟	短縮よみ	
ちょすいくつ	貯水窟	名詞	
ちょすいくつ	アリア川貯水窟	短縮よみ	
きほう	輝宝	名詞	
おうこくへい	王国兵	名詞	
せんじん	戦神	名詞	
せんち	戦知	名詞	
うぃざーどりぃ	ウィザードリィ	名詞	
＃ｗ	#Wizardry_Online	短縮よみ	
ｍｒぱんぷきん	Mr.パンプキン	名詞	
ぱんぷきん	Mr.パンプキン	短縮よみ	
あらはぅい	アラハゥイ	人名	
あらはぅい	Arahawi	人名	
らんばーじゃっく	ランバージャック	名詞	
すくるーじびーとる	スクルージビートル	名詞	
がーべっじ	ガーベッジ	名詞	
すわんぷふぃあー	スワンプフィアー	名詞	
ここうのぎんろう	孤高の銀狼	名詞	
ここうのぎんろうしるばーふぁんぐ	孤高の銀狼シルバーファング	名詞	
しるばーふぁんぐ	シルバーファング	名詞	
しるばーふぁんぐ	孤高の銀狼シルバーファング	短縮よみ	
ばっどろーず	バッドローズ	名詞	
ひどらぷらんと	ヒドラプラント	名詞	
びじたーぷらんと	ジビタープラント	名詞	
いんぴゅりてぃー	インピュリティー	名詞	
やせいのぱてぃしえ	野生のパティシエ	名詞	
やせいのぱてぃしえぴーちすぱいだー	野生のパティシエピーチスパイダー	名詞	
ぴーちすぱいだー	ピーチスパイダー	名詞	
ぴーちすぱいだー	野生のパティシエピーチスパイダー	短縮よみ	
あらくれたんけんたい	荒くれ探検隊	名詞	
あらくれたんけんたいあるごす	荒くれ探検隊アルゴス	名詞	
あるごす	アルゴス	名詞	
あるごす	荒くれ探検隊アルゴス	名詞	
のーびすふぁいたー	ノービスファイター	名詞	
ですきゃりあー	デスキャリアー	名詞	
うぉれっとふろっぐ	ウォレットフロッグ	名詞	
ほうもつのばんにん	宝物の番人	名詞	
ほうもつのばんにんぐりーどいーたー	宝物の番人グリードイーター	名詞	
ぐりーどいーたー	グリードイーター	名詞	
ぐりーどいーたー	宝物の番人グリードイーター	短縮よみ	
こぐーる	コグール	名詞	
ずーる	ズール	名詞	
ふれっしゅあーまー	フレッシュアーマー	名詞	
しょっくとるーぱー	ショックトルーパー	名詞	
すかるすとーん	スカルストーン	名詞	
あんぐりーふぇいす	アングリーフェイス	名詞	
すてられたもりびと	棄てられた守人	名詞	
すてられたもりびと	棄てられた守人ダニエルサーン	名詞	
だにえるさーん	ダニエルサーン	名詞	
だにえるさーん	棄てられた守人ダニエルサーン	名詞	
ろってぃんぐ	ロッティング	名詞	
りばーあんかー	リバーアンカー	名詞	
りびんぐすたちゅー	リビングスタチュー	名詞	
しりょうつかい	死霊使い	名詞	
しりょうつかいそろぐーヴぁ	死霊使いソログーヴァ	名詞	
そろぐーヴぁ	死霊使いソログーヴァ	短縮よみ	
べのむびーとる	ベノムビートル	名詞	
きらーこいん	キラーコイン	名詞	
ぶらっくかーぺっと	ブラックカーペット	名詞	
わーばっふぁろー	ワーバッファロー	名詞	
ぷろーらー	プローラー	名詞	
しんげきのついせきしゃ	進撃の追跡者	名詞	
しんげきのついせきしゃまくれーん	進撃の追撃者マクレーン	名詞	
まくれーん	マクレーン	名詞	
まくれーん	進撃の追撃者マクレーン	短縮よみ	
どくむしおう	毒蟲王	名詞	
どくむしおうありあつぇつぇ	毒蟲王アリアツェツェ	名詞	
ありあつぇつぇ	アリアツェツェ	名詞	
ありあつぇつぇ	毒蟲王アリアツェツェ	短縮よみ	
ありあつぇつぇもどき	アリアツェツェモドキ	名詞	
かいとうぜるどじゅうさんせい	怪盗ゼルド13世	名詞	
ぶるすぽーん	ブルスポーン	名詞	
あさるとぶる	アサルトブル	名詞	
